########################
#......................$
#......................$
#......###......########
#...#.......###........#
#....#.................#
#.....###..............#
#.........##.#.........#
#......................#
#..............#.......#
#...........###........#
#........##............#
#.....##...............#
#....#.................#
#.@.#******************#
########################