########################
#......................#
#......................#
#.@......*.....*...##..#
#####################..#
#......................#
#......................#
#..##...*.....*........#
#..#####################
#......................#
#......................#
#........*.....*...##..#
#####################..#
$......................#
$......................#
########################