########################
########################
########################
#......................#
#......................#
#......................#
#......................#
#......................#
#......................#
#......................#
#.......###............#
#.@..##......##........$
####.............##....$
###..................###
###..................###
###******************###