########################
#......................#
#......................$
#......###......########
#...#.......###........#
#....#.................#
#.....###..............#
#.........##...........#
#............#.........#
#..............#.......#
#...........###........#
#........##............#
#.....##...............#
#....#.................#
#.@.#******************#
########################