########################
########################
########################
#......................#
#......................#
#......................#
#......................#
#......................#
#......................#
#......................#
#.......###............#
#.@..##......##........#
####.............##....$
###..................###
###..................###
###******************###